            R    800            600
NO ./srcs/ressources/north.xpm
SO ./srcs/ressources/south.xpm
WE ./srcs/ressources/west.xpm
EA ./srcs/ressources/east.XPM
S  ./srcs/ressources/pillar.xpm
F 220,100,0
C 225,30,0

1111111111111111111111111
10000000001100000000000011111111111111111
101100000111000000200000000000000000000001
10010000000000000000000001111111111111111
1111111110110000011100001111
11110111111111011100000010001
11110111111111011101010010001
11000000110101011100000010001
10002000000000001100000010001
10000000000000001101010000001
11000001110101011111011110N0111
11110111 1110101 101111010001
11111111 1111111 111111111111