R 1300 900
NO ./srcs/tex/eagle.xpm
SO ./srcs/tex/south.xpm
WE ./srcs/tex/west.xpm
EA ./srcs/tex/east.xpm
                  C 135,206,235
         F 100,100,100

             1
            101
            101
        1111101
111111111110101111101111
100000000000000333333333
100000000000000000000001
100000000000000000000001
100000222220000303030001
100000200020000000000001
100000200020000300030001
100000200020000000000001111111111
1000002202200003030300000000000001
1000000000000000000000000000000001
100000000000000000000011111111111
10000000000000000000001
100000000000000000000001
1000000000000N0000000001
100000000000000000000001
11111000000000000000000011111111
    111114444444000000000000001
11111000040000000000000011111111
140000004000000000000001
140400004000000000000001
140444444000000000000001
140000000000000000000001
144444400000000000000001
111111100111111111111111
       101
       101
       101
    11110111111
    100000000001
    10111111011
    101    101
     1     1001
          100001
         10000001
        1000000001
       100000000001111111111111111111111111111111111111
      10000000000000000000000000000000000000000000000001
      10000000000000000000000000000000000000000000000001
      10000000000000000000000000000000000000000000000001
      10000000000000000000000000000000000000000000000001
      10000000000000000000000000000000000000000000000001
      10000000000000000000000000000000000000000000000001      10000000000000000000000000000000000000000000000001
      10000000000000000000000000000000000000000000000001      10000000000000000000000000000000000000000000000001
      10000000000000000000000000000000000000000000000001      10000000000000000000000000000000000000000000000001
      10000000000000000000000000000000000000000000000001      10000000000000000000000000000000000000000000000001
      10000000000000000000000000000000000000000000000001      10000000000000000000000000000000000000000000000001
      10000000000000000000000000000000000000000000000001      10000000000000000000000000000000000000000000000001
      10000000000000000000000000000000000000000000000001      10000000000000000000000000000000000000000000000001
      10000000000000000000000000000000000000000000000001      10000000000000000000000000000000000000000000000001
      10000000000000000000000000000000000000000000000001      10000000000000000000000000000000000000000000000001
      10000000000000000000000000000000000000000000000001      10000000000000000000000000000000000000000000000001
      10000000000000000000000000000000000000000000000001      10000000000000000000000000000000000000000000000001
      10000000000000000000000000000000000000000000000001      10000000000000000000000000000000000000000000000001
      10000000000000000000000000000000000000000000000001      10000000000000000000000000000000000000000000000001
      10000000000000000000000000000000000000000000000001      10000000000000000000000000000000000000000000000001
      10000000000000000000000000000000000000000000000001      10000000000000000000000000000000000000000000000001
      10000000000000000000000000000000000000000000000001      10000000000000000000000000000000000000000000000001
      10000000000000000000000000000000000000000000000001      10000000000000000000000000000000000000000000000001
      10000000000000000000000000000000000000000000000001      10000000000000000000000000000000000000000000000001
      10000000000000000000000000000000000000000000000001      10000000000000000000000000000000000000000000000001
      10000000000000000000000000000000000000000000000001      10000000000000000000000000000000000000000000000001
      10000000000000000000000000000000000000000000000001      10000000000000000000000000000000000000000000000001
      10000000000000000000000000000000000000000000000001      10000000000000000000000000000000000000000000000001
      10000000000000000000000000000000000000000000000001      10000000000000000000000000000000000000000000000001
      10000000000000000000000000000000000000000000000001      10000000000000000000000000000000000000000000000001
      10000000000000000000000000000000000000000000000001      10000000000000000000000000000000000000000000000001
      10000000000000000000000000000000000000000000000001      10000000000000000000000000000000000000000000000001
      10000000000000000000000000000000000000000000000001      10000000000000000000000000000000000000000000000001
      10000000000000000000000000000000000000000000000001      10000000000000000000000000000000000000000000000001
      10000000000000000000000000000000000000000000000001      10000000000000000000000000000000000000000000000001
      10000000000000000000000000000000000000000000000001      10000000000000000000000000000000000000000000000001
      10000000000000000000000000000000000000000000000001      10000000000000000000000000000000000000000000000001
      10000000000000000000000000000000000000000000000001      10000000000000000000000000000000000000000000000001
      10000000000000000000000000000000000000000000000001      10000000000000000000000000000000000000000000000001
      10000000000000000000000000000000000000000000000001      10000000000000000000000000000000000000000000000001
      10000000000000000000000000000000000000000000000001      10000000000000000000000000000000000000000000000001
      10000000000000000000000000000000000000000000000001      10000000000000000000000000000000000000000000000001
      10000000000000000000000000000000000000000000000001      10000000000000000000000000000000000000000000000001
      10000000000000000000000000000000000000000000000001      10000000000000000000000000000000000000000000000001
      10000000000000000000000000000000000000000000000001      10000000000000000000000000000000000000000000000001
      10000000000000000000000000000000000000000000000001      10000000000000000000000000000000000000000000000001
      10000000000000000000000000000000000000000000000001      10000000000000000000000000000000000000000000000001
      10000000000000000000000000000000000000000000000001      10000000000000000000000000000000000000000000000001
      10000000000000000000000000000000000000000000000001      10000000000000000000000000000000000000000000000001
      10000000000000000000000000000000000000000000000001      10000000000000000000000000000000000000000000000001
      10000000000000000000000000000000000000000000000001
1111111111111111111111111111111111111111111111111111111111
